...............................
...............................
...............................
...............................
........+++++.....+++++........
........+###+.....+###+........
........+###+.....+###+........
........+###+.....+###+........
........+++++.....+++++........
..A.........................B..
........+++++.....+++++........
........+###+.....+###+........
........+###+.....+###+........
........+###+.....+###+........
........+++++.....+++++........
...............................
...............................
...............................
...............................
