+++++++++++++++++++++++++++++++++++
...........+++.......+++...........
...................................
..........+++++.....+++++..........
..........+###+.....+###+..........
..........+###+.....+###+..........
..........+###+.....+###+..........
..........+###+.....+###+..........
..........+++++.....+++++..........
..A.............................B..
..........+++++.....+++++..........
..........+###+.....+###+..........
..........+###+.....+###+..........
..........+###+.....+###+..........
..........+###+.....+###+..........
..........+++++.....+++++..........
...................................
...........+++.......+++...........
+++++++++++++++++++++++++++++++++++
